1111111111111111111111111111111111
1000000000C000C00000000000000C0001
10000000C000000C0000C00000000C0001
1000000000C0000000C0000000E0000001
100000C00000000C0000000C0000000001
10000000000C0000000C00000000C00001
1000000C00000000000000000C00000001
1000C000000C00C0000C00000000000001
10000000C000000C0000000C00000C0001
1000000000000C0000000C0000000C0001
10000000C000000000E0000C0000000001
100000000000000P0000000000000C0001
10000000C00000000000000000000C0001
1000C000000C0000000C00000000000001
1000000000000000000000000C00000001
1000C00000000000C00000000C00000001
100000000C000000000000000000000001
1000C00000000000000C00000000C00001
10000000000C0000000000000C00000001
1000C000000C0000C0000C000000C00001
10000000C000000C00000E000000C00001
1111111111111111111111111111111111