111111
1C0011
101P01
10CEE1
111111